111111111111111111
100P00000000100C01
1E01C111000X0C0001
10CC00011111000001
111111111111111111
