11111
110P1
1E101
11CC1
11111
