11111
100P1
1E0K1
10CC1
11111
