11111
100P1
0E001
10CC1
11111
