11111
100P1
1E111
11CC1
11111
