11111
100P1
1E000
10CC1
11111
