111111111111111111
100P00000000100001
1001C111000X0E0001
10CC00011111000001
111111111111111111
