11111
100P1
1E001
10CC1
11111

