11111
100P1
1E001
11CC1
 1111
 