111111111111111111
100P000000001000C1
1E01C11100X000C001
10CC00011111000001
111111111111111111
