11111
100P1
1E001
1XCC1
11111
